65 100
####################################################################################################
#..................................................................................................#
#..#########...#########...#########...#########...#########...#########...#########...#########...#
#..#PPPPPPP#...#PPPPPPP#...#PPPPPPP#...#PPPPPPP#...#PPPPPPP#...#PPPPPPP#...#PPPPPPP#...#PPPPPPP#...#
#..................................................................................................#
#..#PPPPPPP#...#PPPPPPP#...#PPPPPPP#...#PPPPPPP#...#PPPPPPP#...#PPPPPPP#...#PPPPPPP#...#PPPPPPP#...#
#..#########...#########...#########...#########...#########...#########...#########...#########...#
#..................................................................................................#
#..#########...#########...#########...#########...#########...#########...#########...#########...#
#..#PPPPPPP#...#PPPPPPP#...#PPPPPPP#...#PPPPPPP#...#PPPPPPP#...#PPPPPPP#...#PPPPPPP#...#PPPPPPP#...#
#..................................................................................................#
#..#PPPPPPP#...#PPPPPPP#...#PPPPPPP#...#PPPPPPP#...#PPPPPPP#...#PPPPPPP#...#PPPPPPP#...#PPPPPPP#...#
#..#########...#########...#########...#########...#########...#########...#########...#########...#
#..................................................................................................#
#..#########...#########...#########...#########...#########...#########...#########...#########...#
#..#PPPPPPP#...#PPPPPPP#...#PPPPPPP#...#PPPPPPP#...#PPPPPPP#...#PPPPPPP#...#PPPPPPP#...#PPPPPPP#...#
#..................................................................................................#
#..#PPPPPPP#...#PPPPPPP#...#PPPPPPP#...#PPPPPPP#...#PPPPPPP#...#PPPPPPP#...#PPPPPPP#...#PPPPPPP#...#
#..#########...#########...#########...#########...#########...#########...#########...#########...#
#..................................................................................................#
#..#########...#########...#########...#########...#########...#########...#########...#########...#
#..#PPPPPPP#...#PPPPPPP#...#PPPPPPP#...#PPPPPPP#...#PPPPPPP#...#PPPPPPP#...#PPPPPPP#...#PPPPPPP#...#
#..................................................................................................#
#..#PPPPPPP#...#PPPPPPP#...#PPPPPPP#...#PPPPPPP#...#PPPPPPP#...#PPPPPPP#...#PPPPPPP#...#PPPPPPP#...#
#..#########...#########...#########...#########...#########...#########...#########...#########...#
#..................................................................................................#
#..#########...#########...#########...#########...#########...#########...#########...#########...#
#..#PPPPPPP#...#PPPPPPP#...#PPPPPPP#...#PPPPPPP#...#PPPPPPP#...#PPPPPPP#...#PPPPPPP#...#PPPPPPP#...#
#..................................................................................................#
#..#PPPPPPP#...#PPPPPPP#...#PPPPPPP#...#PPPPPPP#...#PPPPPPP#...#PPPPPPP#...#PPPPPPP#...#PPPPPPP#...#
#..#########...#########...#########...#########...#########...#########...#########...#########...#
#..................................................................................................#
#..#########...#########...#########...#########...#########...#########...#########...#########...#
#..#PPPPPPP#...#PPPPPPP#...#PPPPPPP#...#PPPPPPP#...#PPPPPPP#...#PPPPPPP#...#PPPPPPP#...#PPPPPPP#...#
#..................................................................................................#
#..#PPPPPPP#...#PPPPPPP#...#PPPPPPP#...#PPPPPPP#...#PPPPPPP#...#PPPPPPP#...#PPPPPPP#...#PPPPPPP#...#
#..#########...#########...#########...#########...#########...#########...#########...#########...#
#..................................................................................................#
#..#########...#########...#########...#########...#########...#########...#########...#########...#
#..#PPPPPPP#...#PPPPPPP#...#PPPPPPP#...#PPPPPPP#...#PPPPPPP#...#PPPPPPP#...#PPPPPPP#...#PPPPPPP#...#
#..................................................................................................#
#..#PPPPPPP#...#PPPPPPP#...#PPPPPPP#...#PPPPPPP#...#PPPPPPP#...#PPPPPPP#...#PPPPPPP#...#PPPPPPP#...#
#..#########...#########...#########...#########...#########...#########...#########...#########...#
#..................................................................................................#
#..#########...#########...#########...#########...#########...#########...#########...#########...#
#..#PPPPPPP#...#PPPPPPP#...#PPPPPPP#...#PPPPPPP#...#PPPPPPP#...#PPPPPPP#...#PPPPPPP#...#PPPPPPP#...#
#..................................................................................................#
#..#PPPPPPP#...#PPPPPPP#...#PPPPPPP#...#PPPPPPP#...#PPPPPPP#...#PPPPPPP#...#PPPPPPP#...#PPPPPPP#...#
#..#########...#########...#########...#########...#########...#########...#########...#########...#
#..................................................................................................#
#..#########...#########...#########...#########...#########...#########...#########...#########...#
#..#PPPPPPP#...#PPPPPPP#...#PPPPPPP#...#PPPPPPP#...#PPPPPPP#...#PPPPPPP#...#PPPPPPP#...#PPPPPPP#...#
#..................................................................................................#
#..#PPPPPPP#...#PPPPPPP#...#PPPPPPP#...#PPPPPPP#...#PPPPPPP#...#PPPPPPP#...#PPPPPPP#...#PPPPPPP#...#
#..#########...#########...#########...#########...#########...#########...#########...#########...#
#..................................................................................................#
#..#########...#########...#########...#########...#########...#########...#########...#########...#
#..#TTTTTTT#...#TTTTTTT#...#TTTTTTT#...#TTTTTTT#...#TTTTTTT#...#TTTTTTT#...#TTTTTTT#...#TTTTTTT#...#
#..................................................................................................#
#..#TTTTTTT#...#TTTTTTT#...#TTTTTTT#...#TTTTTTT#...#TTTTTTT#...#TTTTTTT#...#TTTTTTT#...#TTTTTTT#...#
#..#########...#########...#########...#########...#########...#########...#########...#########...#
#..................................................................................................#
#..................................................................................................#
#..................................................................................................#
###############################################..E..################################################
