70 100
#################################################.E.################################################
#..................................................................................................#
#..#########...#########...#########...#########....########...#########...#########...#########...#
#..#PPPPPPP#...#PPPPPPP#...#PPPPPPP#...#PPPPPPP#....PPPPPPP#...#PPPPPPP#...#PPPPPPP#...#PPPPPPP#...#
#..................................................................................................#
#..#PPPPPPP#...#PPPPPPP#...#PPPPPPP#...#PPPPPPP#....PPPPPPP#...#PPPPPPP#...#PPPPPPP#...#PPPPPPP#...#
#..#########...#########...#########...#########....########...#########...#########...#########...#
#..................................................................................................#
#..#########...#########...#########...#########....########...#########...#########...#########...#
#..#PPPPPPP#...#PPPPPPP#...#PPPPPPP#...#PPPPPPP#....PPPPPPP#...#PPPPPPP#...#PPPPPPP#...#PPPPPPP#...#
#..................................................................................................#
#..#PPPPPPP#...#PPPPPPP#...#PPPPPPP#...#PPPPPPP#....PPPPPPP#...#PPPPPPP#...#PPPPPPP#...#PPPPPPP#...#
#..#########...#########...#########...#########....########...#########...#########...#########...#
#..................................................................................................#
#..#########...#########...#########...#########....########...#########...#########...#########...#
#..#PPPPPPP#...#PPPPPPP#...#PPPPPPP#...#PPPPPPP#....PPPPPPP#...#PPPPPPP#...#PPPPPPP#...#PPPPPPP#...#
#..................................................................................................#
#..#PPPPPPP#...#PPPPPPP#...#PPPPPPP#...#PPPPPPP#....PPPPPPP#...#PPPPPPP#...#PPPPPPP#...#PPPPPPP#...#
#..#########...#########...#########...#########....########...#########...#########...#########...#
#..................................................................................................#
#..#########...#########...#########...#########....########...#########...#########...#########...#
#..#PPPPPPP#...#PPPPPPP#...#PPPPPPP#...#PPPPPPP#....PPPPPPP#...#PPPPPPP#...#PPPPPPP#...#PPPPPPP#...#
#..................................................................................................#
#..#PPPPPPP#...#PPPPPPP#...#PPPPPPP#...#PPPPPPP#....PPPPPPP#...#PPPPPPP#...#PPPPPPP#...#PPPPPPP#...#
#..#########...#########...#########...#########....########...#########...#########...#########...#
#..................................................................................................#
#..#########...#########...#########...#########....########...#########...#########...#########...#
#..#PPPPPPP#...#PPPPPPP#...#PPPPPPP#...#PPPPPPP#....PPPPPPP#...#PPPPPPP#...#PPPPPPP#...#PPPPPPP#...#
#..................................................................................................#
#..#PPPPPPP#...#PPPPPPP#...#PPPPPPP#...#PPPPPPP#....PPPPPPP#...#PPPPPPP#...#PPPPPPP#...#PPPPPPP#...#
#..#########...#########...#########...#########....########...#########...#########...#########...#
#..................................................................................................#
#..#########...#########...#########...#########....########...#########...#########...#########...#
#..#PPPPPPP#...#PPPPPPP#...#PPPPPPP#...#PPPPPPP#....PPPPPPP#...#PPPPPPP#...#PPPPPPP#...#PPPPPPP#...#
#..................................................................................................#
#..#PPPPPPP#...#PPPPPPP#...#PPPPPPP#...#PPPPPPP#....PPPPPPP#...#PPPPPPP#...#PPPPPPP#...#PPPPPPP#...#
#..#########...#########...#########...#########....########...#########...#########...#########...#
#..................................................................................................#
#..#########...#########...#########...#########....########...#########...#########...#########...#
#..#PPPPPPP#...#PPPPPPP#...#PPPPPPP#...#PPPPPPP#....PPPPPPP#...#PPPPPPP#...#PPPPPPP#...#PPPPPPP#...#
....................................................................................................
E..................................................................................................E
....................................................................................................
#..#########...#########...#########...#########....########...#########...#########...#########...#
#..#PPPPPPP#...#PPPPPPP#...#PPPPPPP#...#PPPPPPP#....PPPPPPP#...#PPPPPPP#...#PPPPPPP#...#PPPPPPP#...#
#..................................................................................................#
#..#PPPPPPP#...#PPPPPPP#...#PPPPPPP#...#PPPPPPP#....PPPPPPP#...#PPPPPPP#...#PPPPPPP#...#PPPPPPP#...#
#..#########...#########...#########...#########....########...#########...#########...#########...#
#..................................................................................................#
#..#########...#########...#########...#########....########...#########...#########...#########...#
#..#PPPPPPP#...#PPPPPPP#...#PPPPPPP#...#PPPPPPP#....PPPPPPP#...#PPPPPPP#...#PPPPPPP#...#PPPPPPP#...#
#..................................................................................................#
#..#PPPPPPP#...#PPPPPPP#...#PPPPPPP#...#PPPPPPP#....PPPPPPP#...#PPPPPPP#...#PPPPPPP#...#PPPPPPP#...#
#..#########...#########...#########...#########....########...#########...#########...#########...#
#..................................................................................................#
#..#########...#########...#########...#########....########...#########...#########...#########...#
#..#PPPPPPP#...#PPPPPPP#...#PPPPPPP#...#PPPPPPP#....PPPPPPP#...#PPPPPPP#...#PPPPPPP#...#PPPPPPP#...#
#..................................................................................................#
#..#PPPPPPP#...#PPPPPPP#...#PPPPPPP#...#PPPPPPP#....PPPPPPP#...#PPPPPPP#...#PPPPPPP#...#PPPPPPP#...#
#..#########...#########...#########...#########....########...#########...#########...#########...#
#..................................................................................................#
#..#########...#########...#########...#########....########...#########...#########...#########...#
#..#PPPPPPP#...#PPPPPPP#...#TTTTTTT#...#TTTTTTT#....TTTTTTT#...#TTTTTTT#...#PPPPPPP#...#PPPPPPP#...#
#..................................................................................................#
#..#PPPPPPP#...#PPPPPPP#...#TTTTTTT#...#TTTTTTT#....TTTTTTT#...#TTTTTTT#...#PPPPPPP#...#PPPPPPP#...#
#..#########...#########...#########...#########....########...#########...#########...#########...#
#..................................................................................................#
#..#########...#########...#########...#########....########...#########...#########...#########...#
#..#PPPPPPP#...#PPPPPPP#...#TTTTTTT#...#TTTTTTT#....TTTTTTT#...#TTTTTTT#...#PPPPPPP#...#PPPPPPP#...#
#..................................................................................................#
#..#PPPPPPP#...#PPPPPPP#...#TTTTTTT#...#TTTTTTT#....TTTTTTT#...#TTTTTTT#...#PPPPPPP#...#PPPPPPP#...#
#..#########...#########...#########...#########....########...#########...#########...#########...#
#..................................................................................................#
#..#########...#########...#########...#########....########...#########...#########...#########...#
#..#PPPPPPP#...#PPPPPPP#...#TTTTTTT#...#TTTTTTT#....TTTTTTT#...#TTTTTTT#...#PPPPPPP#...#PPPPPPP#...#
#..................................................................................................#
#..#PPPPPPP#...#PPPPPPP#...#TTTTTTT#...#TTTTTTT#....TTTTTTT#...#TTTTTTT#...#PPPPPPP#...#PPPPPPP#...#
#..#########...#########...#########...#########....########...#########...#########...#########...#
#..................................................................................................#
#..................................................................................................#
#..................................................................................................#
#################################################.E.################################################
